12 12 12 12 12 12 12 12 12 12 12 12 12 12 12 12 12 12 12 12 12 12 12 12 12 12 12 12 12 12 12 12 12 12 12 12 12 12 12 12
12 15 15 15 15 15 15 15 15 15 15 15 15 15 15 15 15 15 13 14 15 15 15 15 15 15 15 15 15 15 15 15 15 15 15 15 15 15 15 12
12 15 15 15 15 12 12 15 15 15 12 12 15 15 15 12 12 15 13 14 15 12 12 15 15 15 12 12 15 15 15 12 12 15 15 15 12 12 15 12
12 15 15 15 15 12 12 15 15 15 12 12 15 15 15 12 12 15 13 14 15 12 12 15 15 15 12 12 15 15 15 12 12 15 15 15 12 12 15 12
12 15 15 15 15 15 15 15 15 15 15 15 15 15 15 15 15 15 13 14 15 15 15 15 15 15 15 15 15 15 15 15 15 15 15 15 15 15 15 12
12 15 15 15 15 15 15 15 15 15 15 15 15 15 15 15 15 15 13 14 15 15 15 15 15 15 15 15 15 15 15 15 15 15 15 15 15 15 15 12
12 15 15 15 15 15 15 15 15 15 15 15 15 15 15 15 15 15 13 14 15 15 15 15 15 15 15 15 15 15 15 15 15 15 15 15 15 15 15 12
12 15 15 15 15 12 12 15 15 15 12 12 15 15 15 12 12 15 13 14 15 12 12 15 15 15 12 12 15 15 15 12 12 15 15 15 12 12 15 12
12 15 15 15 15 12 12 15 15 15 12 12 15 15 15 12 12 15 13 14 15 12 12 15 15 15 12 12 15 15 15 12 12 15 15 15 12 12 15 12
12 15 15 15 15 15 15 15 15 15 15 15 15 15 15 15 15 15 13 14 15 15 15 15 15 15 15 15 15 15 15 15 15 15 15 15 15 15 15 12
12 15 15 15 15 15 15 15 15 15 15 15 15 15 15 15 15 15 13 14 15 15 15 15 15 15 15 15 15 15 15 15 15 15 15 15 15 15 15 12
12 15 15 15 15 15 15 15 15 15 15 15 15 15 15 15 15 15 13 14 15 15 15 15 15 15 15 15 15 15 15 15 15 15 15 15 15 15 15 12
12 15 15 15 15 12 12 15 15 15 12 12 15 15 15 12 12 15 13 14 15 12 12 15 15 15 12 12 15 15 15 12 12 15 15 15 12 12 15 12
12 15 15 15 15 12 12 15 15 15 12 12 15 15 15 12 12 15 13 14 15 12 12 15 15 15 12 12 15 15 15 12 12 15 15 15 12 12 15 12
12 15 15 15 15 15 15 15 15 15 15 15 15 15 15 15 15 15 13 14 15 15 15 15 15 15 15 15 15 15 15 15 15 15 15 15 15 15 15 12
12 15 15 15 15 15 15 15 15 15 15 15 15 15 15 15 15 15 13 14 15 15 15 15 15 15 15 15 15 15 15 15 15 15 15 15 15 15 15 12
12 15 15 15 15 15 15 15 15 15 15 15 15 15 15 15 15 15 13 14 15 15 15 15 15 15 15 15 15 15 15 15 15 15 15 15 15 15 15 12
12 15 15 15 15 12 12 15 15 15 12 12 15 15 15 12 12 15 13 14 15 12 12 15 15 15 12 12 15 15 15 12 12 15 15 15 12 12 15 12
12 15 15 15 15 12 12 15 15 15 12 12 15 15 15 12 12 15 13 14 15 12 12 15 15 15 12 12 15 15 15 12 12 15 15 15 12 12 15 12
12 15 15 15 15 15 15 15 15 15 15 15 15 15 15 15 15 15 13 14 15 15 15 15 15 15 15 15 15 15 15 15 15 15 15 15 15 15 15 12
12 15 15 15 15 15 15 15 15 15 15 15 15 15 15 15 15 15 13 14 15 15 15 15 15 15 15 15 15 15 15 15 15 15 15 15 15 15 15 12
12 15 15 15 15 15 15 15 15 15 15 15 15 15 15 15 15 15 13 14 15 15 15 15 15 15 15 15 15 15 15 15 15 15 15 15 15 15 15 12
12 12 12 12 12 12 12 12 12 12 12 12 12 12 12 12 12 12 12 12 12 12 12 12 12 12 12 12 12 12 12 12 12 12 12 12 12 12 12 12