1 1 1 1 1 1 1 1 1 1 1 1 1 1 1 1 1 1 1 1 1 1 1 1 1 1 1 1 1 1 1 1 1 1 1 1 1 1 1 1
1 8 0 0 0 0 0 0 0 0 0 0 0 0 0 0 0 0 0 0 0 0 0 0 0 0 0 0 0 0 0 0 0 0 0 0 0 0 0 1
1 8 8 0 0 0 0 0 0 0 0 0 0 0 0 0 0 0 0 0 0 0 0 0 0 0 0 0 0 0 0 0 0 0 0 0 0 0 0 1
1 0 8 8 0 0 0 0 0 0 0 0 0 0 0 0 0 0 0 0 0 0 0 0 0 0 0 0 0 0 0 0 0 0 0 0 0 0 0 1
1 0 0 8 8 0 0 0 0 0 0 0 0 0 0 0 0 0 0 0 0 0 0 0 0 0 0 0 0 0 0 0 0 0 0 0 0 0 0 1
1 0 0 0 8 8 0 0 0 0 0 0 0 0 0 0 0 0 0 0 0 0 0 0 0 0 0 0 0 0 0 0 0 0 0 0 0 0 0 1
1 0 0 0 0 8 8 0 0 0 0 0 0 0 0 0 0 0 0 0 0 0 0 0 0 0 0 0 0 0 0 0 0 0 0 0 0 0 0 1
1 0 0 0 0 0 8 8 0 0 0 0 0 0 0 0 0 0 0 0 0 0 0 0 0 0 0 0 0 0 0 0 0 0 0 0 0 0 0 1
1 0 0 0 0 0 0 8 8 0 0 0 0 0 0 2 2 0 0 2 2 2 0 0 0 2 0 0 0 2 0 0 0 0 0 0 0 0 0 1
1 0 0 0 0 0 0 0 8 8 8 8 0 0 2 2 2 2 2 2 2 2 2 0 2 2 2 2 2 2 2 2 0 0 0 0 0 0 0 1 
2 2 2 2 2 2 2 2 2 2 2 8 8 8 2 2 2 2 2 2 2 2 2 2 2 2 2 2 2 2 2 2 2 2 2 2 2 2 2 2
2 2 2 2 2 2 2 2 2 2 2 8 8 8 2 2 2 2 2 2 2 2 2 2 2 2 2 2 2 2 2 2 2 2 2 2 2 2 2 2
1 0 0 0 0 0 0 0 0 0 2 8 8 8 8 8 2 2 2 2 2 2 2 2 2 2 2 2 2 2 2 2 2 8 0 0 0 0 0 1
1 0 0 0 0 0 0 0 0 0 0 2 2 2 2 8 8 2 2 2 2 2 2 2 2 2 2 2 2 2 2 0 8 8 8 0 0 0 0 1
1 0 0 0 0 0 0 0 0 0 0 2 2 2 2 2 8 8 2 2 2 2 2 2 2 2 2 2 2 2 2 0 0 8 0 0 0 0 0 1
1 0 0 0 0 0 0 0 0 0 0 0 0 0 0 8 8 2 2 2 2 2 2 2 2 2 2 2 2 2 2 0 0 0 0 8 0 0 0 1
1 0 0 0 0 0 0 0 0 0 0 0 0 0 0 0 8 8 2 2 2 2 2 2 2 2 2 2 2 2 2 0 0 0 0 0 8 0 0 1
1 0 0 0 0 0 0 0 0 0 0 2 2 2 2 0 0 8 8 2 2 2 2 2 2 2 2 2 2 2 2 0 0 0 0 0 0 8 0 1
1 0 0 0 0 0 0 0 0 0 0 2 2 2 2 0 0 0 8 8 8 8 2 2 2 2 2 2 2 2 2 0 0 0 0 0 0 0 8 1
1 0 0 0 0 0 0 0 0 0 0 0 0 0 0 0 0 0 8 8 8 8 2 2 2 2 2 2 2 2 2 0 0 0 0 0 8 8 0 1
1 0 0 0 0 0 0 0 0 0 0 0 0 0 0 0 0 0 0 8 8 8 8 2 2 2 2 2 2 2 2 0 0 0 0 0 8 8 8 1
1 0 0 0 0 0 0 0 0 0 0 0 0 0 0 0 0 0 0 0 0 0 0 0 0 0 0 0 0 0 0 0 0 0 0 8 8 8 8 1
1 1 1 1 1 1 1 1 1 1 1 1 1 1 1 1 1 1 1 1 1 1 1 1 1 1 1 1 1 1 1 1 1 1 1 1 1 1 1 1