16 16 16 16 16 16 16 16 16 16 16 16 16 16 16 16 16 16 16 16 16 16 16 16 16 16 16 16 16 16 16 16 16 16 16 16 16 16 16 16
16 5 5 5 5 5 5 5 5 5 5 5 5 5 5 5 5 5 5 5 5 5 5 5 5 5 5 5 5 5 5 5 5 5 5 5 5 5 5 16
16 5 5 5 5 5 5 5 5 5 5 5 5 5 5 5 5 5 5 5 5 5 5 5 5 5 5 5 5 5 5 5 5 5 5 5 5 5 5 16
16 5 5 5 5 5 5 5 5 5 5 5 5 5 5 5 5 5 5 5 5 5 5 5 5 5 5 5 5 5 5 5 5 5 5 5 5 5 5 16
16 5 5 5 5 5 5 5 5 5 5 5 5 5 5 5 5 5 5 5 5 5 5 5 5 5 5 5 5 5 5 5 5 5 5 5 5 5 5 16
16 5 5 5 5 5 5 5 5 5 5 5 5 5 5 5 5 5 5 5 5 5 5 5 5 5 5 5 5 5 5 5 5 5 5 5 5 5 5 16
16 5 5 5 5 5 16 16 16 16 16 5 5 5 5 5 5 5 5 5 5 5 5 16 16 16 16 16 5 5 5 5 5 5 5 5 5 5 5 16
16 5 5 5 5 5 16 16 16 16 16 5 5 5 5 5 5 5 5 5 5 5 5 16 16 16 16 16 5 5 5 5 5 5 5 5 5 5 5 16
16 5 5 5 5 5 16 16 16 16 16 5 5 5 5 5 5 5 5 5 5 5 5 16 16 16 16 16 5 5 5 5 5 5 5 5 5 5 5 16
16 5 5 5 5 5 16 16 16 16 16 5 5 5 5 5 5 5 5 5 5 5 5 16 16 16 16 16 5 5 5 5 5 5 5 5 5 5 5 16
16 5 5 5 5 5 16 16 16 16 16 5 5 5 5 5 5 5 5 5 5 5 5 16 16 16 16 16 5 5 5 5 5 5 5 5 5 5 5 16
16 5 5 5 5 5 5 5 5 5 5 5 5 5 5 5 5 5 5 5 5 5 5 5 5 5 5 5 5 5 5 5 5 5 5 5 5 5 5 16
16 5 5 5 5 5 5 5 5 5 5 5 5 5 5 5 5 5 5 5 5 5 5 5 5 5 5 5 5 5 5 5 5 5 5 5 5 5 5 16
16 5 5 5 5 5 16 16 16 16 16 5 5 5 5 5 5 5 5 5 5 5 5 16 16 16 16 16 5 5 5 5 5 5 5 5 5 5 5 16
16 5 5 5 5 5 16 16 16 16 16 5 5 5 5 5 5 5 5 5 5 5 5 16 16 16 16 16 5 5 5 5 5 5 5 5 5 5 5 16
16 5 5 5 5 5 16 16 16 16 16 5 5 5 5 5 5 5 5 5 5 5 5 16 16 16 16 16 5 5 5 5 5 5 5 5 5 5 5 16
16 5 5 5 5 5 16 16 16 16 16 5 5 5 5 5 5 5 5 5 5 5 5 16 16 16 16 16 5 5 5 5 5 5 5 5 5 5 5 16
16 5 5 5 5 5 16 16 16 16 16 5 5 5 5 5 5 5 5 5 5 5 5 16 16 16 16 16 5 5 5 5 5 5 5 5 5 5 5 16
16 5 5 5 5 5 5 5 5 5 5 5 5 5 5 5 5 5 5 5 5 5 5 5 5 5 5 5 5 5 5 5 5 5 5 5 5 5 5 16
16 5 5 5 5 5 5 5 5 5 5 5 5 5 5 5 5 5 5 5 5 5 5 5 5 5 5 5 5 5 5 5 5 5 5 5 5 5 5 16
16 5 5 5 5 5 5 5 5 5 5 5 5 5 5 5 5 5 5 5 5 5 5 5 5 5 5 5 5 5 5 5 5 5 5 5 5 5 5 16
16 5 5 5 5 5 5 5 5 5 5 5 5 5 5 5 5 5 5 5 5 5 5 5 5 5 5 5 5 5 5 5 5 5 5 5 5 5 5 16
16 16 16 16 16 16 16 16 16 16 16 16 16 16 16 16 16 16 16 16 16 16 16 16 16 16 16 16 16 16 16 16 16 16 16 16 16 16 16 16